11 13
WWWWWWSWWWWWW
WWW.WW.WWWWWW
W......WW...W
W.W.WWWW..W.W
W.W......WW.W
W.W.WWWWWWW.W
W.W.WW......W
W.W....WW.WWW
W.WWWW.WWWWWW
W...W.....WWW
WWWWWWWEWWWWW